term,cur,prev,diff,ma7,z_like,total
 ,783,553,230,553.143,9.375,5134
l,63,20,43,22.0,7.205,196
o,49,19,30,15.286,6.867,147
스,77,21,56,31.714,6.829,298
임,25,5,20,5.286,5.976,41
레,42,9,33,14.286,5.798,116
게,22,3,19,4.857,5.351,43
플,36,8,28,13.0,4.994,105
c,26,5,21,7.571,4.912,83
쿄,13,0,13,1.857,4.716,13
e,52,23,29,24.143,4.711,240
g,38,9,29,15.429,4.58,140
탑,12,1,11,2.0,4.142,15
훈,14,2,12,2.857,4.142,21
쇼,13,0,13,2.571,4.005,21
영,24,11,13,8.429,3.989,72
n,22,8,14,7.429,3.911,77
장,29,9,20,12.286,3.71,117
디,37,10,27,18.0,3.624,151
윤,11,1,10,2.143,3.595,15
m,16,8,8,4.714,3.559,48
화,21,9,12,7.714,3.517,74
d,40,17,23,20.571,3.51,176
험,10,0,10,1.857,3.446,18
산,21,6,15,8.286,3.278,88
입,11,2,9,2.571,3.237,22
존,10,2,8,2.143,3.189,18
회,14,3,11,4.571,3.005,41
공,22,8,14,10.0,2.883,109
도,30,15,15,16.0,2.8,136
씨,10,2,8,2.714,2.752,28
t,25,11,14,12.571,2.734,131
업,20,3,17,9.143,2.698,91
엔,15,4,11,5.857,2.673,47
선,15,8,7,6.0,2.609,55
억,8,0,8,1.857,2.6,15
성,37,22,15,22.714,2.478,213
템,7,1,6,1.571,2.409,12
체,12,1,11,4.571,2.367,45
급,10,5,5,3.429,2.304,34
케,7,0,7,1.714,2.289,19
주,23,11,12,13.0,2.171,122
옥,5,0,5,0.857,2.151,7
허,5,0,5,0.857,2.151,9
비,17,9,8,8.714,2.097,77
트,23,15,8,13.286,2.091,116
달,7,2,5,2.0,2.071,18
마,16,6,10,8.143,2.039,80
와,10,4,6,4.0,2.0,34
료,7,3,4,2.143,1.971,18
녹,4,0,4,0.571,1.953,5
의,25,9,16,15.429,1.942,129
서,19,10,9,10.714,1.939,95
이,64,39,25,48.571,1.936,445
프,16,5,11,8.571,1.891,73
제,15,11,4,7.857,1.878,84
삼,22,11,11,13.286,1.876,118
p,13,8,5,6.429,1.859,62
환,6,2,4,1.714,1.856,19
b,11,6,5,5.0,1.854,66
0,29,19,10,19.286,1.802,202
소,12,9,3,5.857,1.796,60
참,7,0,7,2.429,1.787,17
완,4,0,4,0.714,1.781,6
특,6,3,3,1.857,1.753,18
x,8,0,8,3.143,1.752,28
토,5,1,4,1.286,1.741,12
국,11,9,2,5.286,1.732,67
시,31,27,4,21.286,1.73,212
수,26,18,8,17.286,1.69,141
티,8,2,6,3.286,1.676,33
최,11,6,5,5.429,1.673,55
미,11,8,3,5.429,1.673,61
작,6,1,5,2.0,1.657,21
6,13,10,3,7.0,1.646,60
y,5,0,5,1.429,1.627,23
확,5,1,4,1.429,1.627,14
초,7,3,4,2.714,1.619,24
사,22,19,3,14.429,1.578,128
은,16,15,1,9.571,1.57,73
옴,3,0,3,0.429,1.554,3
웹,3,0,3,0.429,1.554,3
3,13,6,7,7.286,1.545,67
우,9,3,6,4.286,1.535,38
네,5,0,5,1.571,1.521,18
논,4,1,3,1.0,1.5,9
적,9,4,5,4.429,1.473,39
세,17,11,6,10.714,1.471,97
질,7,2,5,3.0,1.464,22
r,11,8,3,6.0,1.449,75
술,5,1,4,1.714,1.423,18
러,8,3,5,3.857,1.398,30
중,8,5,3,3.857,1.398,35
금,11,4,7,6.143,1.396,51
8,6,2,4,2.429,1.396,30
독,6,3,3,2.429,1.396,22
클,6,3,3,2.429,1.396,24
괴,3,0,3,0.571,1.383,4
침,3,1,2,0.571,1.383,5
엄,4,0,4,1.143,1.381,9
조,12,10,2,7.0,1.371,61
운,9,2,7,4.857,1.293,41
팅,4,2,2,1.286,1.272,12
크,8,2,6,4.143,1.271,43
교,7,0,7,3.429,1.252,39
h,7,5,2,3.429,1.252,38
양,5,1,4,2.0,1.243,16
틱,3,0,3,0.714,1.239,10
황,3,0,3,0.714,1.239,5
반,9,0,9,5.0,1.236,48
행,9,9,0,5.0,1.236,40
s,18,17,1,12.571,1.194,137
력,7,2,5,3.571,1.186,37
관,9,5,4,5.143,1.18,52
택,4,0,4,1.429,1.171,10
결,6,6,0,2.857,1.168,25
승,5,4,1,2.143,1.16,23
부,13,11,2,8.571,1.128,76
치,7,5,2,3.714,1.122,33
냉,2,0,2,0.286,1.117,2
맑,2,0,2,0.286,1.117,2
봬,2,0,2,0.286,1.117,3
붕,2,0,2,0.286,1.117,2
습,2,0,2,0.286,1.117,3
쓱,2,0,2,0.286,1.117,2
큼,2,0,2,0.286,1.117,2
탕,2,0,2,0.286,1.117,2
팡,2,0,2,0.286,1.117,4
폐,2,0,2,0.286,1.117,4
복,3,0,3,0.857,1.113,9
션,3,0,3,0.857,1.113,13
단,6,1,5,3.0,1.098,38
계,8,5,3,4.571,1.093,48
종,4,1,3,1.571,1.078,16
열,4,2,2,1.571,1.078,16
로,20,10,10,14.857,1.059,142
기,27,18,9,21.143,1.046,205
넘,3,0,3,1.0,1.0,8
봇,3,0,3,1.0,1.0,12
외,3,0,3,1.0,1.0,10
컴,3,0,3,1.0,1.0,11
페,3,0,3,1.0,1.0,13
홈,3,0,3,1.0,1.0,7
앞,3,1,2,1.0,1.0,8
협,4,1,3,1.714,0.99,26
견,2,0,2,0.429,0.95,3
령,2,0,2,0.429,0.95,6
릴,2,0,2,0.429,0.95,3
섭,2,0,2,0.429,0.95,3
첫,2,0,2,0.429,0.95,3
칭,2,0,2,0.429,0.95,3
털,2,0,2,0.429,0.95,4
히,2,0,2,0.429,0.95,4
혜,2,1,1,0.429,0.95,3
투,5,5,0,2.571,0.933,28
리,20,15,5,15.429,0.928,149
감,8,4,4,5.0,0.927,43
민,4,2,2,1.857,0.907,22
으,4,2,2,1.857,0.907,19
할,4,1,3,2.0,0.828,18
여,4,2,2,2.0,0.828,23
매,4,3,1,2.0,0.828,18
출,9,9,0,6.143,0.821,60
따,2,0,2,0.571,0.814,5
념,2,1,1,0.571,0.814,4
쿠,2,1,1,0.571,0.814,9
향,2,1,1,0.571,0.814,11
랜,3,1,2,1.286,0.803,11
u,3,2,1,1.286,0.803,22
닉,3,2,1,1.286,0.803,13
원,11,8,3,8.0,0.784,77
신,11,10,1,8.0,0.784,91
1,22,18,4,18.0,0.763,162
테,4,3,1,2.143,0.754,21
하,11,4,7,8.143,0.741,75
현,5,2,3,3.0,0.732,30
식,5,5,0,3.0,0.732,29
대,23,26,-3,19.143,0.718,179
합,3,0,3,1.429,0.716,16
규,3,2,1,1.429,0.716,16
귀,2,0,2,0.714,0.697,6
밥,2,0,2,0.714,0.697,5
빌,2,0,2,0.714,0.697,11
융,2,1,1,0.714,0.697,6
츠,2,1,1,0.714,0.697,8
약,4,4,0,2.286,0.682,23
파,5,3,2,3.143,0.67,33
품,5,5,0,3.143,0.67,29
a,26,16,10,22.286,0.649,235
인,22,11,11,18.571,0.646,159
맞,3,3,0,1.571,0.634,13
년,8,5,3,5.857,0.627,53
곽,1,0,1,0.143,0.622,1
긍,1,0,1,0.143,0.622,1
껴,1,0,1,0.143,0.622,2
꼼,1,0,1,0.143,0.622,1
낳,1,0,1,0.143,0.622,1
님,1,0,1,0.143,0.622,1
닷,1,0,1,0.143,0.622,1
돕,1,0,1,0.143,0.622,1
둔,1,0,1,0.143,0.622,1
땡,1,0,1,0.143,0.622,1
떠,1,0,1,0.143,0.622,1
뜻,1,0,1,0.143,0.622,1
랠,1,0,1,0.143,0.622,3
런,1,0,1,0.143,0.622,2
렉,1,0,1,0.143,0.622,2
록,1,0,1,0.143,0.622,2
롭,1,0,1,0.143,0.622,1
맛,1,0,1,0.143,0.622,1
먼,1,0,1,0.143,0.622,2
멸,1,0,1,0.143,0.622,1
벡,1,0,1,0.143,0.622,1
뻤,1,0,1,0.143,0.622,1
좌,1,0,1,0.143,0.622,1
챌,1,0,1,0.143,0.622,1
큐,1,0,1,0.143,0.622,1
팝,1,0,1,0.143,0.622,3
핌,1,0,1,0.143,0.622,1
힘,1,0,1,0.143,0.622,1
없,2,1,1,0.857,0.593,9
는,12,6,6,9.571,0.593,88
동,10,15,-5,7.857,0.563,73
준,3,1,2,1.714,0.557,13
을,5,3,2,3.429,0.551,28
전,27,29,-2,24.0,0.509,234
란,2,1,1,1.0,0.5,10
군,2,2,0,1.0,0.5,9
태,2,2,0,1.0,0.5,11
w,3,0,3,1.857,0.484,22
율,3,0,3,1.857,0.484,16
혼,3,0,3,1.857,0.484,13
오,7,9,-2,5.429,0.472,55
긴,1,0,1,0.286,0.465,5
납,1,0,1,0.286,0.465,2
냥,1,0,1,0.286,0.465,3
렸,1,0,1,0.286,0.465,5
롤,1,0,1,0.286,0.465,3
립,1,0,1,0.286,0.465,7
뮬,1,0,1,0.286,0.465,2
벼,1,0,1,0.286,0.465,3
빼,1,0,1,0.286,0.465,3
슬,1,0,1,0.286,0.465,4
았,1,0,1,0.286,0.465,3
엠,1,0,1,0.286,0.465,4
엣,1,0,1,0.286,0.465,4
염,1,0,1,0.286,0.465,4
있,1,0,1,0.286,0.465,3
잘,1,0,1,0.286,0.465,3
춤,1,0,1,0.286,0.465,4
콜,1,0,1,0.286,0.465,2
톤,1,0,1,0.286,0.465,3
팔,1,0,1,0.286,0.465,2
픈,1,0,1,0.286,0.465,5
꿈,1,1,0,0.286,0.465,2
워,9,9,0,7.286,0.463,56
일,8,9,-1,6.429,0.444,67
덩,2,0,2,1.143,0.414,8
불,2,0,2,1.143,0.414,10
더,2,1,1,1.143,0.414,9
베,2,1,1,1.143,0.414,14
액,2,1,1,1.143,0.414,9
음,2,3,-1,1.143,0.414,12
루,3,2,1,2.0,0.414,20
블,3,2,1,2.0,0.414,17
만,8,3,5,6.571,0.401,57
남,5,1,4,3.857,0.386,29
무,5,3,2,3.857,0.386,32
증,5,5,0,3.857,0.386,34
타,6,2,4,4.857,0.357,42
손,3,0,3,2.143,0.348,16
움,3,2,1,2.143,0.348,16
법,3,6,-3,2.143,0.348,17
곤,1,0,1,0.429,0.345,3
냅,1,0,1,0.429,0.345,3
밋,1,0,1,0.429,0.345,3
변,1,0,1,0.429,0.345,8
빛,1,0,1,0.429,0.345,7
암,1,0,1,0.429,0.345,3
짜,1,0,1,0.429,0.345,3
철,1,0,1,0.429,0.345,3
컬,1,0,1,0.429,0.345,4
퀄,1,0,1,0.429,0.345,3
탁,1,0,1,0.429,0.345,5
혁,1,0,1,0.429,0.345,12
같,1,1,0,0.429,0.345,4
례,1,1,0,0.429,0.345,6
꾼,1,2,-1,0.429,0.345,3
송,1,2,-1,0.429,0.345,6
압,1,2,-1,0.429,0.345,5
솔,2,0,2,1.286,0.335,18
온,2,1,1,1.286,0.335,9
처,2,1,1,1.286,0.335,10
표,2,1,1,1.286,0.335,12
천,2,2,0,1.286,0.335,14
패,2,3,-1,1.286,0.335,12
i,21,16,5,19.429,0.291,229
련,3,1,2,2.286,0.284,21
락,3,4,-1,2.286,0.284,18
닥,2,1,1,1.429,0.26,13
